0000000000000000000000000000
0000000000000000000000000000
0000000000000000000000000000
############################
#............##............#
#.####.#####.##.#####.####.#
#0####.#####.##.#####.####0#
#.####.#####.##.#####.####.#
#..........................#
#.####.##.########.##.####.#
#.####.##.########.##.####.#
#......##....##....##......#
######.#####.##.#####.######
00000#.#####.##.#####.#00000
00000#.##..........##.#00000
00000#.##.###00###.##.#00000
######.##.#000000#.##.######
..........#000000#..........
######.##.#000000#.##.######
00000#.##.########.##.#00000
00000#.##..........##.#00000
00000#.##.########.##.#00000
######.##.########.##.######
#............##............#
#.####.#####.##.#####.####.#
#.####.#####.##.#####.####.#
#0..##.......00.......##..0#
###.##.##.########.##.##.###
###.##.##.########.##.##.###
#......##....##....##......#
#.##########.##.##########.#
#.##########.##.##########.#
#..........................#
############################
0000000000000000000000000000
0000000000000000000000000000